11111111111
100EC00C101
1000C0P0101
1000000C111
11111111111
