1111111111111111111111111111111111
1E00000000000000000000000000000001
1010010010100000101001000000010101
1010011010101010001001000000010101
1P0000000000N000000000000000000001
100000000000000000N000000000000001
1000000000000000000000000000000001
100000000000CN00000000000000000001
1111111111111111111111111111111111
