111111111111111111111
100000100000C10000001
10P0000001C11100000E1
111111110111110000001
111111110000000111111
111111111111111111111
