111111111111111111111111111
100000100000C100000E1111111
10P0000001C1110000001111111
111111110111110000001111111
11111111000N000000000111111
11111111000N011000000111111
11111111000N011000000111111
11111111000N011000000111111
11111111000N011000000111111
11111111000N111000000111111
11111111000N111000000111111
11111111000N001100000111111
111111110001111100000111111
11111111000N000000000111111
111111111111111111111111111
